---###
---#.#
####-#
#@$--#
###--#
--####,
    #####
    #   #
    #$  #
  ###  $##
  #  $ $ #
### # ## #   ######
#   # ## #####  ..#
# $  $          ..#
##### ### #@##  ..#
    #     #########
    #######,
####
# .#
#  ###
#*@  #
#  $ #
#  ###
####,
######
#    #
# #@ #
# $* #
# .* #
#    #
######,
  ####
###  ####
#     $ #
# #  #$ #
# . .#@ #
#########,
########
#      #
# .**$@#
#      #
#####  #
    ####
