---###
---#.#
####-#
#@$--#
###--#
--####,
    #####
    #   #
    #$  #
  ###  $##
  #  $ $ #
### # ## #   ######
#   # ## #####  ..#
# $  $          ..#
##### ### #@##  ..#
    #     #########
    #######,
####
# .#
#  ###
#*@  #
#  $ #
#  ###
####,
######
#    #
# #@ #
# $* #
# .* #
#    #
######,
  ####
###  ####
#     $ #
# #  #$ #
# . .#@ #
#########,
########
#      #
# .**$@#
#      #
#####  #
    ####,
 #######
 #     #
 # .$. #
## $@$ #
#  .$. #
#      #
########,
###### #####
#    ###   #
# $$     #@#
# $ #...   #
#   ########
#####,
#######
#     #
# .$. #
# $.$ #
# .$. #
# $.$ #
#  @  #
#######,
  ######
  # ..@#
  # $$ #
  ## ###
   # #
   # #
#### #
#    ##
# #   #
#   # #
###   #
  #####,
#####
#.  ##
#@$$ #
##   #
 ##  #
  ##.#
   ###,
      #####
      #.  #
      #.# #
#######.# #
# @ $ $ $ #
# # # # ###
#       #
#########,
  ######
  #    #
  # ##@##
### # $ #
# ..# $ #
#       #
#  ######
####,
#####
#   ##
# $  #
## $ ####
 ###@.  #
  #  .# #
  #     #
  #######,
####
#. ##
#.@ #
#. $#
##$ ###
 # $  #
 #    #
 #  ###
 ####,
#######
#     #
# # # #
#. $*@#
#   ###
#####,
     ###
######@##
#    .* #
#   #   #
#####$# #
    #   #
    #####,
 ####
 #  ####
 #     ##
## ##   #
#. .# @$##
#   # $$ #
#  .#    #
##########,
#####
# @ #
#...#
#$$$##
#    #
#    #
######,
#######
#     #
#. .  #
# ## ##
#  $ #
###$ #
  #@ #
  #  #
  ####,
########
#   .. #
#  @$$ #
##### ##
   #  #
   #  #
   #  #
   ####,
#######
#     ###
#  @$$..#
#### ## #
  #     #
  #  ####
  #  #
  ####